******************************************************************************************
*       *                                                                                *
*       *                                                                                *
**** ****                                                                                *
*                                                                                        *
*                                                                                        *
*                                                                                        *
*                                                                                        *
*                                                                                        *
*                                   ************** ***********                           *
*                                   *                        *                           *
*                                   *                        *                           *
*                                   *                        ********** ******************
*                                   *                        *                           *
******************** ****************                                                    *
*                                                            *                           *
******************************************************************************************