************************************************************
*           *              *          *     *            * *
****** * ** * ************ * **** *** * ***   *** **     * *
*    * * **                                 *     **       *
*           ****** * ***** * **** *** ***** ***** **     * *
*    * * **   **** *                  *           **     * *
*    * * ** * **** * ******* **** *** ***** **** ********* *
****** * **        *                  ***** **** ********* *
*           * **** * ******* **********          *      ** *
* **** * ** *      * ******* ********** ********** **** ** *
*      * ** ******                                 **** ** *
* **** * *         * ******* ********** ********** ****    *
* ** * * ********* *    **       * *             * **** ** *
* ** *             * *  ** *****   * *  *  *  *  *      ** *
* ** *********** * * *  ** ***** * *             ********* *
*                       ** ***** * * *  *  *  *  ********* *
* ** ****  ***** * * ** *                                  *
* ** ***** *     * * ** *************************** ****** *
* ** ** ** * *** * *                                       *
* ** ** ** * *** * *********** ******* ******* **** ****** *
*          *     *                                         *
************************************************************
